1 1 1 1 1 1 1 1 1 1 1 1 1 1 1 1
1 0 0 0 0 0 0 0 0 0 0 0 0 0 0 1
1 0 0 0 4 4 4 4 4 4 4 0 0 0 0 1
1 0 0 0 4 3 3 3 3 3 4 0 0 0 0 1
1 0 0 0 4 3 2 2 2 3 4 0 0 0 0 1
1 0 0 0 4 3 2 2 2 3 4 0 0 0 0 0
1 0 0 0 4 3 2 2 2 3 4 0 0 0 0 0
1 0 0 0 4 3 3 3 3 3 4 0 0 0 0 1
1 0 0 0 4 4 4 4 4 4 4 0 5 5 5 1
1 0 0 0 0 0 0 0 0 0 0 0 5 5 5 1
1 0 0 0 0 0 0 0 0 0 0 0 5 5 5 1
1 1 1 1 1 1 1 1 1 1 1 1 1 1 1 1